2
26
14
19
12
#############d############
########...........#######
#######.............######
########............##..##
###################.#....#
#####...................c#
#####..##############....#
#####..###############..##
#####..###################
#...................c#####
#######.###########.######
#.................#.######
#...............c.#.######
##########################