3
26
14
13
12
##########################
##########################
######..............######
####..................####
##......................##
#........................#
#........................#
#........................#
##.......................#
###.....................##
###...................####
#####.........c.....######
#############.############
##########################