1
26
14
9
12
###################d######
#c.......................#
#......#.................#
########..################
########.................#
########..################
#......#................c#
#........................#
#..######.################
#.......#.################
#.......#.################
#.......#.################
#...c...#.################
##########################